-----W----
--S--W--S-
-----W----
--WWWWWW--
----------
----------
----W---WW
----W-----
-P--W--S--
----W-----
