10
-----W----
--KS-WSW-E
-----W-W--
TTWWWW-WWW
F---------
---F------
----WWDWWW
----W-----
-P--W--S--
----W--B--
uullddrr
uudddu
rrll