10 0.5868
WWWWWWWWWW
W-K--WS-PW
WS---W-WEW
WTTWWW-WWW
WF-------W
W---F----W
W---WWDWWW
W---W--S-W
W---W--B-W
W--WWWWWWW
uddu
drrudllu
rrlllr