10
-----W----
---S-W--S-
-----W----
TTWWWWWWTT
----------
----------
----WTTTWW
----W-----
-P--W--S--
----W-----
uullddrr
rrlllr
rrll