10
-----W----
---S-W--S-
-----W----
TTWWWWWWTT
F---------
---F------
----WTTTWW
----W-----
-P--W--S--
----W-----
uullddrr
rrlllr
rrll