10 0.596
W-PWWW-WWW
W----F---W
W--WWWWWDW
WTTWBTW-SW
W-SWTSWT-W
WS-W--W-SW
WTTWSTWS-W
W-----S--W
W-K---S-EW
WWWWWWWWWW
rl
rl
udlr
lr
du
du
lr
lr
lr